11111111111
1P000000111
11101110111
1C010000111
1C011110E11
1C000000011
11101110111
1C000000C11
1C011101C11
11111111111
