1111111111111111111111111111111111
10E0000000000000000000000000000001
1P11110100100000101001000000010101
1011110010101010001001000000010101
1000000000000000000000001010000001
101111010010000C101001000000010101
1011110010101010001001000000010101
1011110100100000101001000000010101
1011110010101010001001000000010101
1011110100100000101001000000010101
101111001010101000100100000001M101
1111111111111111111111111111111111
