1111111111
1111111111
1P000E0MC1
1000000001
1111111111
1111111111
