111111
1P0C01
101001
1C0001
1E0001
100001
111111
