1111111111
1P00000011
1110111011
1C01000011
1C011110E1
1C00000001
1110111011
1C000000C1
1CM11101C1
1000000001
1111111111
