1111111111111111111111111111111111
1E00000000000000C00000C00000000001
1011110100100000101001000000010101
1011110010101010001001000000010101
1P0000000C00C000000000001C10000001
1011110100100000101001000000010101
1011110010101010001001000000010101
1011110100100000101001000000010101
1011110010101010001001000000010101
1011110100100000101001000000M10101
1011110010101010001001000000010101
1111111111111111111111111111111111
